1 0 3 0 0 1 2
2 1 2 0 0 1 0
1 1 1 1 1 1 1
5 5 5 5 5 5 5
9 9 9 9 9 9 9