2 5 6 2 2 0 2 1 1 4 6
5 2 5 2 5 3 0 5 4 0 0
6 6 6 0 6 4 6 3 4 3 6
5 3 2 2 0 4 3 5 3 6 6
6 4 4 5 1 0 0 5 4 2 0
3 5 4 1 1 6 6 2 6 0 2
1 2 1 0 2 4 3 3 5 1 0
1 1 6 0 2 0 4 4 0 4 3
1 4 4 0 2 4 1 1 6 3 4
6 5 0 0 1 5 3 5 2 4 6
